################################
#                              #
#                              #
#           #          #       #
#                              #
#   #                          #
#                              #
#        #                     #
#                     #        #
#                              #
#                      #       #
#         #                    #
#                              #
#                      #       #
#             #                #
#                              #
#                       #      #
################################